111111111
1P0000001
1100000111
10E0000C1
111111111
