11111111111
11110001111
11110000011
10000000001
10001000001
10000000001
1C000000001
10000000001
100111P0001
100111E0011
11111111111