1111111111
10000A0001
1000001001
1P00100001
1000111001
10000C10E1
1111111111