11111111111111111
1C1E1CCC0000S0001
101011111000C0011
1010000000000C001
10111111100010001
10P00000000010001
1000000C0CCC0C001
111110000CCCCC011
11S00000011111111
11111111111111111
