1111111111111111111
1S1100000E0000011S1
111100000C000001111
1S1100000C0000011S1
111C00000C00000C111
111C00000C00000C111
1S1100000C0000011S1
111100000C000001S11
1S1100000P0000011S1
1111111111111111111
