111111111
100000001
110000011
10E000001
111111111
