111111111
1P0000001
110000011
1000000C1
111111111