111111111
100000001
110000011
10E0000C1
111111111
