111111111
1P0000001
110000011
10E0000C1
111111011
