111111111
1P0000001
110000010
10E0000C1
111111111
