111111111
1P0000001
110000011
10E0001C1
111111111
