111111111
1P0000001
010000011
10E0000C1
111111111
