111111111
1P0000001
110000P11
10E0000C1
111111111
