111111111
1P0000001
11000E011
10E0000C1
111111111
