111111111
1P0000001
110000011
10E00C0C1
111111111
