   NO    ./txt/john-fowler-7Ym9rpYtSdA-unsplash.xpm     
   EA ./txt/beautiful-shining-stars-night-sky.xpm



WE ./txt/beautiful-shining-stars-night-sky.xpm
SO ./txt/vincentiu-solomon-ln5drpv_ImI-unsplash.xpm

   F    0,0,0   




 C   100,  100,  100


  11111111111111     
11100000010111111111    
1100000011110000001
100W000110000000001
1100000011110011111
1000000011100000111
1100000011111000111
1000000000000000001
1111111111111111111
