NO ./txt/john-fowler-7Ym9rpYtSdA-unsplash.xpm
EA ./txt/beautiful-shining-stars-night-sky.xpm
WE ./txt/beautiful-shining-stars-night-sky.xpm
SO ./txt/vincentiu-solomon-ln5drpv_ImI-unsplash.xpm

F 0,0,0

C 102,0,204


111111111111111111111111111111111
100000000000000010000000000000001
110000001111000000000000011000001
100E00011000000000000000000000001
110000001111001111100000000000001
100000001110000011100000000110001
110000001111100011100000000000001
100000000000000000000000000000001
111111111110000001100000000000001
111111000000111001111111111111111
     111111111111111    111111111