NO ./txt/black.xpm
EA ./txt/bluestone.xpm
WE ./txt/redbrick.xpm    
SO ./txt/wood.xpm

F 0,0,0   

C 100,100,255

111111111
110000001
110000001
100E00011
110000001   
100000001
1100000011111111111
1000000000000000001
1111111111111111111
	111111
