11111111111111111
1C1E1CCC0000C0001
101011111000C0011
101000000000C0001
10111111100010001
10P00000000010001
1000000C0CCC01001
111110000CCC1C111
11000000011111111
11111111111111111
